222222222222200000000000000000000000000000000000000000000000
222222222222200000000000000000000000000000000000000000000000
222222222222200000000000000000000000000000000000000000000000
222222222222200000000000000000000000000000000000000000000000
222222222222200000000000000000000000000000000000000000000000
222222222222200000000000000000000000000000000000000000000000
222222222222200000000000000000000000000000000000000000000000
222222222222200000000000000000000000000000000000000000000000
222222222222200000000000000000000000000000000000000000000000
222222222222200000000000000000000000000000000000000000000000
222222222222200000000000000000000000000000000000000000000000
222222222222200000000000000000000000000000000000000000000000
222222222222200000000000000000000000000000000000000000000000
222222222222200000000000000000000000000000000000000000000000
222222222222200000000000000000000000000000000000000000000000
222222222222200000000000000000000000000000000000000000000000
222222222222200000000000000000000000000000000000000000000000
222222222222200000000000000000000000000000000000000000000000
222222222222200000000000000000000000000000000000000000000000
222222222222200000000000000000000000000000000000000000000000
222222222222200000000000000000000000000000000000000000000000
2222222222222000000000000000B0000001111111111111111111111111
222222222222211111111111111111111112222222222222222222222222
222222222222222222222222222222222222222222222222222222222222
222222222222222222222222222222222222222222222222222222222222
222222222222222222222222222222222222222222222222222222222222
222222222222222222222222222222222222222222222222222222222222
222222222222222222222222222222222222222222222222222222222222
222222222222222222222222222222222222222222222222222222222222
222222222222222222222222222222222222222222222222222222222222
222222222222222222222222222222222222222222222222222222222222
222222222222222222222222222222222222222222222222222222222222
222222222222222222222222222222222222222222222222222222222222
222222222222222222222222222222222222222222222222222222222222
222222222222222222222222222222222222222222222222222222222222
222222222222222222222222222222222222222222222222222222222222
222222222222222222222222222222222222222222222222222222222222